SO ./textures/south.xpm
NO ./textures/south.xpm
WE ./textures/east.xpm
EA ./textures/east.xpm

             F              1        44,        2   3            8,           144                                
C 135,206,250

11111111
111111
10000011
10011101
1001 101
10011101
100N0001
11111111
