SO ./textures/south.xpm
NO ./textures/south.xpm
WE ./textures/east.xpm
EA ./textures/east.xpm

F 144,238,144
C 135,206,250

11111111
111111
1000001
10011101
1001 101
10011101
100N0001
11111111
