NO ./textures/bluestone.xpm
SO ./textures/eagle.xpm
WE ./textures/purplestone.xpm
EA ./textures/wall_4.xpm

F 144,238,144
C 135,206,250

111111
1000001
1001 11
100S101
1111111
