NO ./textures/hello_kitty.xpm
SO ./textures/hello_kitty.xpm
WE ./textures/hello_kitty.xpm
EA ./textures/hello_kitty.xpm

F 253,217,235
C 253,217,235

111111
1000001
1001 11
100S101
1111111
