NO ./textures/south.xpm
SO ./textures/south.xpm
WE ./textures/east.xpm
EA ./textures/east.xpm

F 144,238,144
C 135,206,250

1111111
111111
1000011
1001101
100N001
1111111
