NO ./textures/north_texture.xpm
SO ./textures/south_texture.xpm
WE ./textures/west_texture.xpm
EA ./textures/east_texture.xpm
F 220,100,0
C 225,30,0

11111111
10000001
10011101
1001 101
10011101
100N0001
11111111
