NO ./textures/south_texture.xpm
SO ./textures/south_texture.xpm
WE ./textures/west_texture.xpm
EA ./textures/west_texture.xpm

F 220,100,0
C 225,30,0

11111
10011
1S001
11111
