NO ./textures/south.xpm
SO ./textures/south.xpm
WE ./textures/east.xpm
EA ./textures/east.xpm

C 35,19,73
F 15,6,40

11111111111111111
11111111111111111
11111110001111111
11111100000111111
11111000N00011111
11110000000001111
11100000000000111
11000011111000011
11100001110000111
11110000100001111
11111000000011111
11111111D11111111
11111110001111111
11111111111111111
