NO ./textures/south.xpm
SO ./textures/south.xpm
WE ./textures/east.xpm
EA ./textures/east.xpm

F 76,76,76
C 99,99,99


111111111111111111111
111111111111111111111
110N00010010010000011
110010000010000010011
110000010011111011111
110011110000010010011
110000D00000000010011
110011111111110010011
111110000000000010111
110000000010000000011
111111111111111111111
111111111111111111111
